2222222222
2000000002
2002000102
2400000002
2222200002
2402000002
2000000002
2002003302
2000000002
2222222222