2222222222A2000000002A2002000102A2400000002A2222200002A2402000002A2000000002A2002003302A2000000002A2222222222A